1111111111111
1000000000001
10X0000000001
1000000000001
100000000Y001
1000000000001
1111111111111
